+--------+
|S****** |
|   *  * |
|  **  * |
|   *  F |
| ***    |
+--------+
